"tier","start","stop","dur","code","dyad"
"Turns",29493,40422,10929,"P10A","MM"
"Turns",40422,44716,4294,"P10C","MM"
"Turns",75490,79532,4042,"P11A","MM"
"Turns",79532,83753,4221,"P11C","MM"
"Turns",153529,158350,4821,"P12A","MM"
"Turns",158350,163624,5274,"P12C","MM"
"Turns",181464,184996,3532,"P13A","MM"
"Turns",184996,191783,6787,"P13C","MM"
"Turns",194094,202089,7995,"P14A","MM"
"Turns",202089,203486,1397,"P14C","MM"
"Turns",388434,392575,4141,"P15A","MM"
"Turns",392575,396387,3812,"P15C","MM"
"Turns",396574,406353,9779,"R1A","MM"
"Turns",406353,408000,1647,"R1C","MM"
"Turns",545259,547543,2284,"26A","MM"
"Turns",547543,549285,1742,"26C","MM"
"Turns",566806,575485,8679,"P3A","MM"
"Turns",575485,577928,2443,"P3C","MM"
"Turns",599499,604492,4993,"28A","MM"
"Turns",604492,608745,4253,"28C","MM"
"Turns",627666,631942,4276,"29A","MM"
"Turns",631942,634328,2386,"29C","MM"
"Turns",736016,742816,6800,"31A","MM"
"Turns",742816,745288,2472,"31C","MM"
"Turns",782999,784927,1928,"32A","MM"
"Turns",784927,786962,2035,"32C","MM"
"Turns",837340,850811,13471,"P4A","MM"
"Turns",850811,853520,2709,"P4C","MM"
"Turns",854075,865292,11217,"23A","MM"
"Turns",865292,866458,1166,"23C","MM"
"Turns",874810,885125,10315,"25A","MM"
"Turns",885125,888139,3014,"25C","MM"
"Turns",889366,891848,2482,"P16A","MM"
"Turns",891848,893234,1386,"P16C","MM"
"Turns",1027359,1033088,5729,"51A","MM"
"Turns",1033088,1037465,4377,"51C","MM"
"Turns",1045792,1057775,11983,"P18A","MM"
"Turns",1057775,1059261,1486,"P18C","MM"
"Turns",1059711,1064509,4798,"P19A","MM"
"Turns",1064509,1066836,2327,"P19C","MM"
"Turns",1067911,1074161,6250,"52A","MM"
"Turns",1074161,1077289,3128,"52C","MM"
"Turns",1077611,1082411,4800,"P20A","MM"
"Turns",1082411,1085625,3214,"P20C","MM"
"Turns",1124411,1127002,2591,"53A","MM"
"Turns",1127002,1130567,3565,"53C","MM"
"Turns",1136320,1143384,7064,"54A","MM"
"Turns",1143384,1148185,4801,"54C","MM"
"Turns",1154398,1163189,8791,"55A","MM"
"Turns",1163189,1168663,5474,"55C","MM"
"Turns",1238519,1240897,2378,"48A","MM"
"Turns",1240897,1243549,2652,"48C","MM"
"Turns",1243602,1244873,1271,"49A","MM"
"Turns",1244873,1246162,1289,"49C","MM"
"Turns",1262073,1265057,2984,"P17A","MM"
"Turns",1265057,1269641,4584,"P17C","MM"
"Turns",1273844,1279531,5687,"27A","MM"
"Turns",1279531,1282263,2732,"27C","MM"
"Turns",1282424,1286457,4033,"30A","MM"
"Turns",1286457,1287979,1522,"30C","MM"
"Turns",1621473,1625140,3667,"50A","MM"
"Turns",1625140,1626731,1591,"50C","MM"
"Turns",1709273,1720082,10809,"1A","MM"
"Turns",1720082,1721539,1457,"1C","MM"
"Turns",1744123,1752337,8214,"3A","MM"
"Turns",1752337,1754759,2422,"3C","MM"
"Turns",1755874,1767748,11874,"4A","MM"
"Turns",1767748,1771626,3878,"4C","MM"
"Turns",1772787,1783707,10920,"2A","MM"
"Turns",1783707,1786627,2920,"2C","MM"
"Turns",1792444,1798525,6081,"5A","MM"
"Turns",1798525,1800217,1692,"5C","MM"
"Turns",1843927,1848302,4375,"6A","MM"
"Turns",1848302,1849731,1429,"6C","MM"
"Turns",1862059,1869524,7465,"7A","MM"
"Turns",1869524,1874009,4485,"7C","MM"
"Turns",1887849,1895101,7252,"8A","MM"
"Turns",1895101,1897094,1993,"8C","MM"
"Turns",1902282,1906439,4157,"9A","MM"
"Turns",1906439,1912482,6043,"9C","MM"
"Turns",1918932,1921845,2913,"10A","MM"
"Turns",1921845,1923750,1905,"10C","MM"
"Turns",1929728,1935130,5402,"11A","MM"
"Turns",1935130,1940143,5013,"11C","MM"
"Turns",1940291,1943491,3200,"12A","MM"
"Turns",1943491,1945991,2500,"12C","MM"
"Turns",1948526,1952969,4443,"13A","MM"
"Turns",1952969,1954685,1716,"13C","MM"
"Turns",1956400,1964572,8172,"14A","MM"
"Turns",1964572,1966860,2288,"14C","MM"
"Turns",1976039,1980908,4869,"15A","MM"
"Turns",1980908,1983118,2210,"15C","MM"
"Turns",1995044,2004303,9259,"16A","MM"
"Turns",2004303,2008668,4365,"16C","MM"
"Turns",2011300,2015928,4628,"17A","MM"
"Turns",2015928,2020133,4205,"17C","MM"
"Turns",2044499,2053701,9202,"18A","MM"
"Turns",2053701,2056878,3177,"18C","MM"
"Turns",2109421,2125449,16028,"19A","MM"
"Turns",2125449,2127369,1920,"19C","MM"
"Turns",2135729,2143366,7637,"20A","MM"
"Turns",2143366,2145764,2398,"20C","MM"
"Turns",2152038,2159982,7944,"21A","MM"
"Turns",2159982,2161839,1857,"21C","MM"
"Turns",2171353,2180800,9447,"34A","MM"
"Turns",2180800,2184743,3943,"34C","MM"
"Turns",2192455,2198740,6285,"35A","MM"
"Turns",2198740,2202038,3298,"35C","MM"
"Turns",2212397,2216669,4272,"22A","MM"
"Turns",2216669,2218162,1493,"22C","MM"
"Turns",2222178,2235051,12873,"P1A","MM"
"Turns",2235051,2237761,2710,"P1C","MM"
"Turns",2258538,2263038,4500,"24A","MM"
"Turns",2263038,2265380,2342,"24C","MM"
"Turns",2523699,2534070,10371,"56A","MM"
"Turns",2534070,2536082,2012,"56C","MM"
"Turns",2596225,2600560,4335,"57A","MM"
"Turns",2600560,2601599,1039,"57C","MM"
"Turns",2734878,2741192,6314,"R2A","MM"
"Turns",2741192,2745339,4147,"R2C","MM"
"Turns",2778476,2783051,4575,"36A","MM"
"Turns",2783051,2788325,5274,"36C","MM"
"Turns",2810054,2812803,2749,"37A","MM"
"Turns",2812803,2815193,2390,"37C","MM"
"Turns",2832726,2836798,4072,"38A","MM"
"Turns",2836798,2840469,3671,"38C","MM"
"Turns",2854918,2859300,4382,"33A","MM"
"Turns",2859300,2860920,1620,"33C","MM"
"Turns",2923127,2929602,6475,"39A","MM"
"Turns",2929602,2934364,4762,"39C","MM"
"Turns",2935204,2940468,5264,"P5A","MM"
"Turns",2940468,2941954,1486,"P5C","MM"
"Turns",2959428,2962651,3223,"P6A","MM"
"Turns",2962651,2963942,1291,"P6C","MM"
"Turns",3078392,3086277,7885,"40A","MM"
"Turns",3086277,3090118,3841,"40C","MM"
"Turns",3196249,3200055,3806,"P7A","MM"
"Turns",3200055,3202938,2883,"P7C","MM"
"Turns",3256572,3262112,5540,"41A","MM"
"Turns",3262112,3263670,1558,"41C","MM"
"Turns",3291805,3293935,2130,"P8A","MM"
"Turns",3293935,3295691,1756,"P8C","MM"
"Turns",3311692,3317846,6154,"42A","MM"
"Turns",3317846,3319759,1913,"42C","MM"
"Turns",3320106,3323469,3363,"43A","MM"
"Turns",3323469,3324740,1271,"43C","MM"
"Turns",3325925,3331948,6023,"44A","MM"
"Turns",3331948,3334968,3020,"44C","MM"
"Turns",3336044,3339311,3267,"45A","MM"
"Turns",3339311,3345498,6187,"45C","MM"
"Turns",3416857,3426540,9683,"P2A","MM"
"Turns",3426540,3429493,2953,"P2C","MM"
"Turns",3461129,3463594,2465,"58A","MM"
"Turns",3463594,3464850,1256,"58C","MM"
"Turns",3513370,3517607,4237,"59A","MM"
"Turns",3517607,3521133,3526,"59C","MM"
"Turns",3530960,3537129,6169,"60A","MM"
"Turns",3537129,3539150,2021,"60C","MM"
"Turns",4201965,4208349,6384,"P9A","MM"
"Turns",4208349,4210349,2000,"P9C","MM"
"Turns",4233568,4237976,4408,"46A","MM"
"Turns",4237976,4240246,2270,"46C","MM"
"Turns",4249873,4254233,4360,"47A","MM"
"Turns",4254233,4256276,2043,"47C","MM"
"Brows_MG",549009,549285,276,"AU1+2","MM"
"Brows_MG",1147298,1148190,892,"AU1+2+4","MM"
"Brows_MG",1240897,1243549,2652,"AU1+2","MM"
"Brows_MG",1720044,1721517,1473,"AU1+2","MM"
"Brows_MG",1847280,1848195,915,"AU1+2","MM"
"Brows_MG",1848204,1849731,1527,"AU1+2","MM"
"Brows_MG",1869200,1874012,4812,"AU1+2+4","MM"
"Brows_MG",1895107,1897107,2000,"AU4+5","MM"
"Brows_MG",1935130,1940143,5013,"AU4","MM"
"Brows_MG",1943500,1945970,2470,"AU1+2","MM"
"Brows_MG",1953810,1954686,876,"AU1+2","MM"
"Brows_MG",1980900,1983100,2200,"AU1+2+4","MM"
"Brows_MG",2159970,2161820,1850,"AU1+2","MM"
"Brows_MG",2600560,2601580,1020,"AU1+2","MM"
"Brows_MG",2786401,2787526,1125,"AU1+2","MM"
"Brows_MG",2859301,2860920,1619,"AU5","MM"
"Brows_MG",3087342,3088502,1160,"AU1+2+4","MM"
"Brows_MG",3088502,3090110,1608,"AU1+2+4","MM"
"Brows_MZ",632880,634337,1457,"AU1+2+4","MM"
"Brows_MZ",743018,745296,2278,"AU1+2","MM"
"Brows_MZ",865520,866458,938,"AU1+2","MM"
"Brows_MZ",1033088,1033920,832,"AU1+2","MM"
"Brows_MZ",1279408,1282270,2862,"AU9","MM"
"Brows_MZ",1798680,1800200,1520,"AU1+2","MM"
"Brows_MZ",2053458,2056858,3400,"AU4","MM"
"Brows_MZ",2125459,2127350,1891,"AU1+2","MM"
"Brows_MZ",2143370,2145770,2400,"AU1+2","MM"
"Brows_MZ",2216607,2218164,1557,"AU1+2+4","MM"
"Brows_MZ",2534070,2536082,2012,"AU1+2","MM"
"Brows_MZ",2836798,2839998,3200,"AU1+2","MM"
"Brows_MZ",3317840,3319759,1919,"AU1+2","MM"
"Brows_MZ",3323470,3324740,1270,"AU1+2","MM"
"Brows_MZ",3331940,3334970,3030,"AU1+2+4","MM"
"Brows_MZ",3517360,3517680,320,"AU4","MM"
"Brows_MZ",3518464,3520765,2301,"AU1+2+4","MM"
"Brows_MZ",3520765,3521105,340,"AU5","MM"
"Brows_MZ",4237976,4240238,2262,"AU1+2","MM"
"Brows_MZ",4254250,4254770,520,"AU1+2","MM"
"Head-mov_MG",549009,549285,276,"HT#tag1","MM"
"Head-mov_MG",1147840,1148185,345,"NM","MM"
"Head-mov_MG",1245870,1246162,292,"NM-BC","MM"
"Head-mov_MG",1287736,1287946,210,"NM","MM"
"Head-mov_MG",1720079,1721499,1420,"HS","MM"
"Head-mov_MG",1848321,1849721,1400,"NM-BC","MM"
"Head-mov_MG",1872530,1873569,1039,"NM-BC","MM"
"Head-mov_MG",1895090,1896090,1000,"HT","MM"
"Head-mov_MG",1935132,1937700,2568,"HT","MM"
"Head-mov_MG",1939140,1939730,590,"NM-BC","MM"
"Head-mov_MG",1944841,1945989,1148,"HS","MM"
"Head-mov_MG",1952966,1953856,890,"HT","MM"
"Head-mov_MG",1980919,1983119,2200,"HT","MM"
"Head-mov_MG",3088140,3090040,1900,"HPb","MM"
"Head-mov_MG",3345110,3345498,388,"HT","MM"
"Head-mov_MG",3464556,3464844,288,"blink","MM"
"Head-mov_MZ",633000,634330,1330,"HT#tag2","MM"
"Head-mov_MZ",742810,744978,2168,"HT","MM"
"Head-mov_MZ",744978,745273,295,"NM","MM"
"Head-mov_MZ",865600,866460,860,"HT","MM"
"Head-mov_MZ",1130169,1130559,390,"blink","MM"
"Head-mov_MZ",1168560,1168663,103,"blink","MM"
"Head-mov_MZ",1798531,1800170,1639,"HPf","MM"
"Head-mov_MZ",1943821,1945251,1430,"NM","MM"
"Head-mov_MZ",2056008,2056878,870,"NM-BC","MM"
"Head-mov_MZ",2125469,2127360,1891,"HT","MM"
"Head-mov_MZ",2143370,2145211,1841,"HT","MM"
"Head-mov_MZ",2145211,2145754,543,"NM-BC","MM"
"Head-mov_MZ",2160260,2161540,1280,"NM","MM"
"Head-mov_MZ",2216652,2217440,788,"HT","MM"
"Head-mov_MZ",2217772,2218160,388,"NM-BC","MM"
"Head-mov_MZ",2263030,2265210,2180,"HT","MM"
"Head-mov_MZ",2814687,2815182,495,"NM-BC","MM"
"Head-mov_MZ",2837580,2840470,2890,"HT","MM"
"Head-mov_MZ",3318740,3319760,1020,"NM","MM"
"Head-mov_MZ",3323910,3324750,840,"HT","MM"
"Head-mov_MZ",3333480,3334888,1408,"HT","MM"
"Head-mov_MZ",3334888,3334968,80,"nod","MM"
"Head-mov_MZ",3517620,3520960,3340,"HT","MM"
"Main-gloss_MG",549009,549285,276,"PO","MM"
"Main-gloss_MG",1243335,1243552,217,"PO","MM"
"Main-gloss_MG",1245870,1246162,292,"PO","MM"
"Main-gloss_MG",1279400,1279560,160,"JIJ","MM"
"Main-gloss_MG",1281753,1282280,527,"JIJ","MM"
"Main-gloss_MG",1626580,1626730,150,"PO","MM"
"Main-gloss_MG",1849640,1849760,120,"PO+JIJ","MM"
"Main-gloss_MG",1912400,1912482,82,"PO","MM"
"Main-gloss_MG",1945225,1945950,725,"PO","MM"
"Main-gloss_MG",1982440,1983111,671,"JULLIE-TWEE","MM"
"Main-gloss_MG",2008389,2008668,279,"PO","MM"
"Main-gloss_MG",2161200,2161440,240,"JIJ","MM"
"Main-gloss_MG",2161440,2161840,400,"PO","MM"
"Main-gloss_MG",2184480,2184743,263,"PO","MM"
"Main-gloss_MG",2201680,2202038,358,"PO","MM"
"Main-gloss_MG",2601480,2601596,116,"JIJ","MM"
"Main-gloss_MG",2784920,2786000,1080,"PO","MM"
"Main-gloss_MG",2788280,2788333,53,"PO","MM"
"Main-gloss_MG",2934250,2934360,110,"JA","MM"
"Main-gloss_MG",3087340,3087650,310,"JIJ","MM"
"Main-gloss_MG",3088508,3088588,80,"JIJ","MM"
"Main-gloss_MG",3088588,3089028,440,"WAT","MM"
"Main-gloss_MG",3090050,3090118,68,"JIJ","MM"
"Main-gloss_MG",3345110,3345498,388,"PO","MM"
"Main-gloss_MG",3464556,3464844,288,"JA","MM"
"Main-gloss_MZ",743360,743680,320,"JIJ","MM"
"Main-gloss_MZ",744883,745265,382,"JIJ","MM"
"Main-gloss_MZ",1033088,1033687,599,"JIJ","MM"
"Main-gloss_MZ",1037360,1037465,105,"fold-hands","MM"
"Main-gloss_MZ",1077190,1077280,90,"hold","MM"
"Main-gloss_MZ",1130169,1130559,390,"PO","MM"
"Main-gloss_MZ",1168560,1168663,103,"hold","MM"
"Main-gloss_MZ",1287786,1287976,190,"JIJ","MM"
"Main-gloss_MZ",1720079,1721499,1420,"HPf#NM-BC","MM"
"Main-gloss_MZ",2143920,2144441,521,"JIJ","MM"
"Main-gloss_MZ",2262680,2262800,120,"WAT","MM"
"Main-gloss_MZ",2262800,2263040,240,"JIJ","MM"
"Main-gloss_MZ",2264920,2265200,280,"JIJ","MM"
"Main-gloss_MZ",2535760,2536076,316,"PO","MM"
"Main-gloss_MZ",2814770,2815193,423,"hold","MM"
"Main-gloss_MZ",2840198,2840469,271,"JIJ","MM"
"Main-gloss_MZ",3262120,3262310,190,"JULLIE-TWEE","MM"
"Main-gloss_MZ",3263310,3263470,160,"hold","MM"
"Main-gloss_MZ",3263470,3263670,200,"JULLIE-TWEE","MM"
"Main-gloss_MZ",3324375,3324735,360,"lenghtening","MM"
"Main-gloss_MZ",3517360,3517680,320,"JIJ","MM"
"Main-gloss_MZ",3519120,3519254,134,"JIJ","MM"
"Main-gloss_MZ",3520853,3521140,287,"JIJ","MM"
"Main-gloss_MZ",3538960,3539277,317,"PO","MM"
"Main-gloss_MZ",4239851,4240245,394,"PO","MM"
"Main-gloss_MZ",4256040,4256276,236,"PO","MM"
"Non-dom_MG",1147850,1148200,350,"PO","MM"
"Non-dom_MG",1721143,1721525,382,"JIJ","MM"
"Non-dom_MG",1873978,1874040,62,"JIJ","MM"
"Non-dom_MG",1896880,1897097,217,"JIJ","MM"
"Non-dom_MG",1938049,1939172,1123,"WAAROM","MM"
"Non-dom_MG",1939172,1939802,630,"PO","MM"
"Non-dom_MG",1939802,1940159,357,"JIJ","MM"
"Non-dom_MG",1954600,1954695,95,"JIJ","MM"
"Non-dom_MZ",634000,634320,320,"PO","MM"
"Non-dom_MZ",2535269,2536076,807,"JIJ","MM"
"Potential turn ends",631942,632760,818,"","MM"
"Potential turn ends",632760,633501,741,"","MM"
"Potential turn ends",633501,634328,827,"","MM"
"Potential turn ends",1767748,1768560,812,"","MM"
"Potential turn ends",1768560,1769083,523,"","MM"
"Potential turn ends",1769083,1771626,2543,"","MM"
"Potential turn ends",1783707,1784732,1025,"","MM"
"Potential turn ends",1784732,1786246,1514,"","MM"
"Potential turn ends",1786246,1786627,381,"","MM"
"Potential turn ends",1869524,1870760,1236,"","MM"
"Potential turn ends",1870760,1872142,1382,"","MM"
"Potential turn ends",1872142,1872920,778,"","MM"
"Potential turn ends",1872920,1874009,1089,"","MM"
"Potential turn ends",1952969,1953800,831,"","MM"
"Potential turn ends",1953800,1954685,885,"","MM"
"Potential turn ends",2004303,2005280,977,"","MM"
"Potential turn ends",2005280,2005880,600,"","MM"
"Potential turn ends",2005880,2008668,2788,"","MM"
"Potential turn ends",2143366,2144440,1074,"","MM"
"Potential turn ends",2144440,2145764,1324,"","MM"
"Potential turn ends",2783051,2784392,1341,"","MM"
"Potential turn ends",2784392,2786215,1823,"","MM"
"Potential turn ends",2786215,2788325,2110,"","MM"
"Potential turn ends",3086277,3087524,1247,"","MM"
"Potential turn ends",3087524,3088508,984,"","MM"
"Potential turn ends",3088508,3089376,868,"","MM"
"Potential turn ends",3089376,3090118,742,"","MM"
"Potential turn ends",3331948,3334108,2160,"","MM"
"Potential turn ends",3334108,3334968,860,"","MM"
"Potential turn ends",3517607,3519259,1652,"","MM"
"Potential turn ends",3519259,3521133,1874,"","MM"
"Brows_YN",167061,167442,381,"AU1+2+4","YR"
"Brows_YN",169370,170699,1329,"AU4+9","YR"
"Brows_YN",232740,236550,3810,"AU1+2+4","YR"
"Brows_YN",259240,261456,2216,"AU4+9","YR"
"Brows_YN",699363,703170,3807,"AU1+2+4","YR"
"Brows_YN",1543450,1544630,1180,"AU1+2+4","YR"
"Brows_YN",2092910,2095410,2500,"AU1+2","YR"
"Brows_YN",2250017,2253017,3000,"AU1+2+4","YR"
"Brows_YN",2274640,2275040,400,"AU4","YR"
"Brows_YN",2291681,2292973,1292,"AU1+2+4","YR"
"Brows_YN",2314495,2315301,806,"AU4","YR"
"Brows_YN",2315317,2315858,541,"AU1+2+4","YR"
"Brows_YN",2358177,2360495,2318,"AU1+2+4","YR"
"Brows_YN",2435800,2437944,2144,"AU1+2+4","YR"
"Brows_YN",2491814,2492681,867,"AU1+2+4","YR"
"Brows_YN",2552729,2554152,1423,"AU5","YR"
"Brows_YN",2595440,2597000,1560,"AU1+2","YR"
"Brows_YN",2689620,2689826,206,"AU1+2","YR"
"Brows_YN",3549309,3550526,1217,"AU1+2","YR"
"Brows_YN",3663749,3664089,340,"AU1+2","YR"
"Brows_YN",3664349,3664950,601,"AU1+2","YR"
"Brows_YN",3706894,3709983,3089,"AU1+2","YR"
"Brows_RC",94580,96695,2115,"AU4","YR"
"Brows_RC",134638,135142,504,"AU1+2","YR"
"Brows_RC",1670620,1671130,510,"AU9","YR"
"Brows_RC",1675881,1679040,3159,"AU1+2+4","YR"
"Brows_RC",1777360,1778851,1491,"AU1+2+4","YR"
"Brows_RC",2590655,2591796,1141,"AU1+2","YR"
"Brows_RC",2719953,2720440,487,"AU1+2","YR"
"Brows_RC",2966272,2967210,938,"AU1+2","YR"
"Brows_RC",3696117,3698251,2134,"AU1+2","YR"
"Brows_RC",3824160,3824960,800,"AU1+2+4","YR"
"Head-mov_YN",169481,170404,923,"HPf","YR"
"Head-mov_YN",170409,170819,410,"HPf#HS","YR"
"Head-mov_YN",234539,236557,2018,"HPf","YR"
"Head-mov_YN",259250,261911,2661,"HPf","YR"
"Head-mov_YN",702380,704508,2128,"HPf","YR"
"Head-mov_YN",708840,708915,75,"blink","YR"
"Head-mov_YN",2250284,2253000,2716,"HPb#HT","YR"
"Head-mov_YN",2290717,2292680,1963,"HT","YR"
"Head-mov_YN",2292680,2293040,360,"Wiggle","YR"
"Head-mov_YN",2315278,2316559,1281,"HPf","YR"
"Head-mov_YN",2329279,2330219,940,"NM-BC","YR"
"Head-mov_YN",2359159,2360486,1327,"NM#HPf","YR"
"Head-mov_YN",2497035,2498442,1407,"HT","YR"
"Head-mov_YN",2552708,2554124,1416,"HT","YR"
"Head-mov_YN",2595371,2596681,1310,"HT","YR"
"Head-mov_YN",2689972,2691072,1100,"NM-BC","YR"
"Head-mov_YN",2936735,2937709,974,"HPb","YR"
"Head-mov_YN",3665522,3665757,235,"nod","YR"
"Head-mov_YN",4291820,4292810,990,"NM-BC","YR"
"Head-mov_RC",55839,59372,3533,"HT","YR"
"Head-mov_RC",94999,96776,1777,"HPb","YR"
"Head-mov_RC",134895,135165,270,"tag3","YR"
"Head-mov_RC",1675247,1679044,3797,"HPf","YR"
"Head-mov_RC",1775160,1778851,3691,"HT","YR"
"Head-mov_RC",1959319,1959712,393,"NM-BC","YR"
"Head-mov_RC",2006221,2007379,1158,"HT","YR"
"Head-mov_RC",2590734,2591805,1071,"HT","YR"
"Head-mov_RC",3696291,3698256,1965,"HPf","YR"
"Main-gloss_YN",170409,170819,410,"tag4","YR"
"Main-gloss_YN",703788,704508,720,"JIJ","YR"
"Main-gloss_YN",708840,708915,75,"self-groom","YR"
"Main-gloss_YN",1135944,1136166,222,"JIJ","YR"
"Main-gloss_YN",2252602,2252999,397,"QS","YR"
"Main-gloss_YN",2316145,2316633,488,"hold","YR"
"Main-gloss_YN",2360215,2360488,273,"hold","YR"
"Main-gloss_YN",2474465,2475186,721,"hold","YR"
"Main-gloss_YN",2496861,2497617,756,"HOEVEEL","YR"
"Main-gloss_YN",2498212,2498382,170,"JIJ","YR"
"Main-gloss_YN",2553986,2554109,123,"PO","YR"
"Main-gloss_YN",2596296,2596977,681,"JIJ","YR"
"Main-gloss_YN",3665659,3665766,107,"JIJ","YR"
"Main-gloss_YN",4088777,4088905,128,"JA","YR"
"Non-dom_YN",2274778,2275320,542,"HOE-LANG","YR"
"Non-dom_YN",2291440,2291800,360,"HOE-LANG","YR"
"Non-dom_YN",2315287,2315808,521,"JIJ","YR"
"Non-dom_YN",2552760,2553500,740,"HOE-LANG","YR"
"Main-gloss_RC",57641,57792,151,"WAT","YR"
"Main-gloss_RC",59194,59389,195,"JULLIE-TWEE","YR"
"Main-gloss_RC",94657,95060,403,"HOE","YR"
"Main-gloss_RC",96158,96798,640,"WAAROM","YR"
"Main-gloss_RC",1360748,1361678,930,"PO","YR"
"Main-gloss_RC",1674946,1675528,582,"HOE","YR"
"Main-gloss_RC",1675528,1675848,320,"PO","YR"
"Main-gloss_RC",1678425,1679053,628,"PO","YR"
"Main-gloss_RC",1778840,1778881,41,"QS","YR"
"Main-gloss_RC",1959520,1959734,214,"PO","YR"
"Main-gloss_RC",2004876,2005046,170,"HOE","YR"
"Main-gloss_RC",2007040,2007160,120,"HOE","YR"
"Main-gloss_RC",2007480,2007520,40,"JIJ","YR"
"Main-gloss_RC",2575517,2575713,196,"PO","YR"
"Main-gloss_RC",2936760,2937308,548,"HOE","YR"
"Main-gloss_RC",2939200,2939736,536,"HOE","YR"
"Main-gloss_RC",2939736,2940019,283,"PO","YR"
"Main-gloss_RC",3827329,3827668,339,"JIJ","YR"
"Main-gloss_RC",4257776,4258728,952,"repetition","YR"
"Non-dom_RC",3827575,3827655,80,"hold","YR"
"Non-dom_RC",3833272,3833590,318,"hold","YR"
"Turns",30101,39866,9765,"57A","YR"
"Turns",39866,42737,2871,"57C","YR"
"Turns",43377,55835,12458,"58A","YR"
"Turns",55835,59381,3546,"58C","YR"
"Turns",83217,94670,11453,"59A","YR"
"Turns",94670,96796,2126,"59C","YR"
"Turns",120248,124876,4628,"60A","YR"
"Turns",124876,135145,10269,"60C","YR"
"Turns",135796,137672,1876,"P4A","YR"
"Turns",137672,140394,2722,"P4C","YR"
"Turns",162039,169386,7347,"16A","YR"
"Turns",169386,170818,1432,"16C","YR"
"Turns",211738,218331,6593,"P16A","YR"
"Turns",218331,223020,4689,"P16C","YR"
"Turns",223651,228918,5267,"P17A","YR"
"Turns",228918,231864,2946,"P17C","YR"
"Turns",232263,234521,2258,"15A","YR"
"Turns",234521,236543,2022,"15C","YR"
"Turns",242539,252710,10171,"P19A","YR"
"Turns",252710,255539,2829,"P19C","YR"
"Turns",255868,259250,3382,"17A","YR"
"Turns",259250,261911,2661,"17C","YR"
"Turns",369922,378811,8889,"P15A","YR"
"Turns",378811,380940,2129,"P15C","YR"
"Turns",699345,702368,3023,"1A","YR"
"Turns",702368,704513,2145,"1C","YR"
"Turns",704513,707336,2823,"2A","YR"
"Turns",707336,708905,1569,"2C","YR"
"Turns",717151,719551,2400,"3A","YR"
"Turns",719551,720651,1100,"3C","YR"
"Turns",1065345,1066778,1433,"4A","YR"
"Turns",1066778,1071440,4662,"4C","YR"
"Turns",1133677,1135901,2224,"5A","YR"
"Turns",1135901,1138081,2180,"5C","YR"
"Turns",1264066,1266751,2685,"P1A","YR"
"Turns",1266751,1267986,1235,"P1C","YR"
"Turns",1354798,1357598,2800,"6A","YR"
"Turns",1357598,1361689,4091,"6C","YR"
"Turns",1462971,1467133,4162,"P2A","YR"
"Turns",1467133,1472817,5684,"P2C","YR"
"Turns",1538979,1543783,4804,"7A","YR"
"Turns",1543783,1545353,1570,"7C","YR"
"Turns",1578936,1581478,2542,"P3A","YR"
"Turns",1581478,1583482,2004,"P3C","YR"
"Turns",1668898,1674689,5791,"8A","YR"
"Turns",1674689,1679041,4352,"8C","YR"
"Turns",1736723,1739792,3069,"P14A","YR"
"Turns",1739792,1744184,4392,"P14C","YR"
"Turns",1771460,1775528,4068,"9A","YR"
"Turns",1775528,1778884,3356,"9C","YR"
"Turns",1859082,1863656,4574,"10A","YR"
"Turns",1863656,1866596,2940,"10C","YR"
"Turns",1955304,1958580,3276,"11A","YR"
"Turns",1958580,1959726,1146,"11C","YR"
"Turns",2002170,2004841,2671,"12A","YR"
"Turns",2004841,2007481,2640,"12C","YR"
"Turns",2069242,2074366,5124,"13A","YR"
"Turns",2074366,2075242,876,"13C","YR"
"Turns",2090839,2093724,2885,"14A","YR"
"Turns",2093724,2095571,1847,"14C","YR"
"Turns",2095625,2097444,1819,"P18A","YR"
"Turns",2097444,2099563,2119,"P18C","YR"
"Turns",2100718,2101998,1280,"P13A","YR"
"Turns",2101998,2104222,2224,"P13C","YR"
"Turns",2166748,2169943,3195,"P20A","YR"
"Turns",2169943,2174576,4633,"P20C","YR"
"Turns",2175835,2180954,5119,"18A","YR"
"Turns",2180954,2185233,4279,"18C","YR"
"Turns",2186023,2190781,4758,"19A","YR"
"Turns",2190781,2194541,3760,"19C","YR"
"Turns",2209845,2211948,2103,"20A","YR"
"Turns",2211948,2213349,1401,"20C","YR"
"Turns",2245197,2250215,5018,"21A","YR"
"Turns",2250215,2253011,2796,"21C","YR"
"Turns",2269929,2274645,4716,"22A","YR"
"Turns",2274645,2276123,1478,"22C","YR"
"Turns",2286790,2290716,3926,"23A","YR"
"Turns",2290716,2292983,2267,"23C","YR"
"Turns",2310806,2314908,4102,"24A","YR"
"Turns",2314908,2316628,1720,"24C","YR"
"Turns",2322128,2328861,6733,"25A","YR"
"Turns",2328861,2330248,1387,"25C","YR"
"Turns",2351222,2357994,6772,"26A","YR"
"Turns",2357994,2360490,2496,"26C","YR"
"Turns",2413521,2420092,6571,"27A","YR"
"Turns",2420092,2424141,4049,"27C","YR"
"Turns",2433267,2435794,2527,"28A","YR"
"Turns",2435794,2437950,2156,"28C","YR"
"Turns",2444024,2450320,6296,"29A","YR"
"Turns",2450320,2453314,2994,"29C","YR"
"Turns",2468486,2473782,5296,"30A","YR"
"Turns",2473782,2475189,1407,"30C","YR"
"Turns",2487127,2497036,9909,"31A","YR"
"Turns",2497036,2498443,1407,"31C","YR"
"Turns",2550122,2552697,2575,"32A","YR"
"Turns",2552697,2554132,1435,"32C","YR"
"Turns",2559616,2564820,5204,"33A","YR"
"Turns",2564820,2566442,1622,"33C","YR"
"Turns",2566987,2572712,5725,"34A","YR"
"Turns",2572712,2575715,3003,"34C","YR"
"Turns",2577155,2581118,3963,"35A","YR"
"Turns",2581118,2585118,4000,"35C","YR"
"Turns",2586018,2590718,4700,"36A","YR"
"Turns",2590718,2591803,1085,"36C","YR"
"Turns",2591879,2595359,3480,"37A","YR"
"Turns",2595359,2596978,1619,"37C","YR"
"Turns",2663251,2666748,3497,"38A","YR"
"Turns",2666748,2669443,2695,"38C","YR"
"Turns",2684969,2689609,4640,"39A","YR"
"Turns",2689609,2691085,1476,"39C","YR"
"Turns",2715751,2719953,4202,"40A","YR"
"Turns",2719953,2721664,1711,"40C","YR"
"Turns",2726851,2729680,2829,"41A","YR"
"Turns",2729680,2731615,1935,"41C","YR"
"Turns",2933529,2936742,3213,"42A","YR"
"Turns",2936742,2940012,3270,"42C","YR"
"Turns",2963020,2966266,3246,"43A","YR"
"Turns",2966266,2969547,3281,"43C","YR"
"Turns",3325751,3334141,8390,"P5A","YR"
"Turns",3334141,3336161,2020,"P5C","YR"
"Turns",3454066,3463502,9436,"P6A","YR"
"Turns",3463502,3465352,1850,"P6C","YR"
"Turns",3513916,3517289,3373,"44A","YR"
"Turns",3517289,3518916,1627,"44C","YR"
"Turns",3519006,3520452,1446,"P7A","YR"
"Turns",3520452,3523684,3232,"P7C","YR"
"Turns",3544181,3549307,5126,"45A","YR"
"Turns",3549307,3550787,1480,"45C","YR"
"Turns",3657841,3663342,5501,"46A","YR"
"Turns",3663342,3665761,2419,"46C","YR"
"Turns",3692545,3696114,3569,"47A","YR"
"Turns",3696114,3698248,2134,"47C","YR"
"Turns",3700430,3706886,6456,"48A","YR"
"Turns",3706886,3711934,5048,"48C","YR"
"Turns",3770690,3779924,9234,"P8A","YR"
"Turns",3779924,3786950,7026,"P8C","YR"
"Turns",3801624,3806919,5295,"49A","YR"
"Turns",3806919,3808517,1598,"49C","YR"
"Turns",3812346,3819559,7213,"P9A","YR"
"Turns",3819559,3821346,1787,"P9C","YR"
"Turns",3821528,3824411,2883,"50A","YR"
"Turns",3824411,3827658,3247,"50C","YR"
"Turns",3828048,3831973,3925,"51A","YR"
"Turns",3831973,3833594,1621,"51C","YR"
"Turns",3854475,3858794,4319,"52A","YR"
"Turns",3858794,3861767,2973,"52C","YR"
"Turns",3934530,3939945,5415,"53A","YR"
"Turns",3939945,3940983,1038,"53C","YR"
"Turns",4036494,4043828,7334,"P10A","YR"
"Turns",4043828,4045477,1649,"P10C","YR"
"Turns",4078082,4085502,7420,"54A","YR"
"Turns",4085502,4088880,3378,"54C","YR"
"Turns",4108774,4111034,2260,"P11A","YR"
"Turns",4111034,4116411,5377,"P11C","YR"
"Turns",4117898,4121586,3688,"P12A","YR"
"Turns",4121586,4128499,6913,"P12C","YR"
"Turns",4252723,4256917,4194,"55A","YR"
"Turns",4256917,4258723,1806,"55C","YR"
"Turns",4289573,4291291,1718,"56A","YR"
"Turns",4291291,4292838,1547,"56C","YR"
"Potential turn ends",94670,95400,730,"","YR"
"Potential turn ends",95400,96796,1396,"","YR"
"Potential turn ends",259250,261457,2207,"","YR"
"Potential turn ends",261457,261911,454,"","YR"
"Potential turn ends",1674689,1675249,560,"","YR"
"Potential turn ends",1675249,1675649,400,"","YR"
"Potential turn ends",1675649,1676369,720,"","YR"
"Potential turn ends",1676369,1676849,480,"","YR"
"Potential turn ends",1676849,1677569,720,"","YR"
"Potential turn ends",1677569,1679041,1472,"","YR"
"Potential turn ends",2004841,2006320,1479,"","YR"
"Potential turn ends",2006320,2006860,540,"","YR"
"Potential turn ends",2006860,2007481,621,"","YR"
"Potential turn ends",2290716,2292623,1907,"","YR"
"Potential turn ends",2292623,2292983,360,"","YR"
"Potential turn ends",2357994,2358714,720,"","YR"
"Potential turn ends",2358714,2359634,920,"","YR"
"Potential turn ends",2359634,2360490,856,"","YR"
"Potential turn ends",2450320,2451680,1360,"","YR"
"Potential turn ends",2451680,2453314,1634,"","YR"
"Potential turn ends",2572712,2574960,2248,"","YR"
"Potential turn ends",2574960,2575715,755,"","YR"
"Potential turn ends",2581118,2584371,3253,"","YR"
"Potential turn ends",2584371,2585118,747,"","YR"
"Potential turn ends",2666748,2668391,1643,"","YR"
"Potential turn ends",2668391,2669443,1052,"","YR"
"Potential turn ends",2936742,2937160,418,"","YR"
"Potential turn ends",2937160,2938360,1200,"","YR"
"Potential turn ends",2938360,2939080,720,"","YR"
"Potential turn ends",2939080,2940012,932,"","YR"
"Potential turn ends",3663342,3663640,298,"","YR"
"Potential turn ends",3663640,3665761,2121,"","YR"
"Potential turn ends",3696114,3696520,406,"","YR"
"Potential turn ends",3696520,3697312,792,"","YR"
"Potential turn ends",3697312,3698248,936,"","YR"
"Potential turn ends",3824411,3825920,1509,"","YR"
"Potential turn ends",3825920,3827658,1738,"","YR"
